12
20
1 10 10 43 42 10 10 10 10 10 10 10 10 10 10 10 10 10 10 0 
3 46 45 27 26 45 45 45 45 45 45 45 45 45 45 45 45 45 46 2 
3 45 45 45 45 45 45 45 45 39 38 45 45 45 45 45 23 22 45 2 
3 45 45 23 14 14 22 45 23 37 36 14 14 14 14 14 37 24 45 2 
3 45 45 25 34 21 26 45 27 21 21 21 21 21 21 21 35 24 45 2 
3 45 45 25 24 47 45 45 45 45 45 45 45 45 45 47 25 24 45 2 
3 45 45 25 24 45 45 45 29 12 12 12 12 12 28 45 25 24 45 2 
3 45 23 37 24 45 45 45 2 44 44 44 44 44 3 45 25 24 45 2 
3 45 27 35 24 45 45 45 2 44 44 44 44 44 3 45 27 26 45 2 
3 45 45 27 26 45 45 45 31 10 11 44 11 10 30 45 45 45 45 2 
3 46 45 45 45 45 45 45 45 45 45 45 45 45 45 45 45 45 46 2 
5 12 12 12 12 12 12 12 12 12 12 12 12 12 12 12 12 12 12 4 
